Reporterka: rzeczownik, mianownik, f, liczba pojedyncza 
babka: rzeczownik, mianownik, f, liczba pojedyncza
na: przyimek  
medal: rzeczownik, biernik, m3, liczba pojedyncza
czeka: czasownik właściwy, liczba pojedyncza, trzecia osoba, aspekt niedokonany, czas teraźniejszy, tryb oznajmujący 
z: przyimek
magnetofonem: rzeczownik, narzędnik, m3, liczba pojedyncza
Tysiące: liczebnik, mianownik/biernik, m3, liczba mnoga 
radiosłuchaczy: rzeczownik, biernik, m1, liczba mnoga
słuchało: czasownik właściwy, liczba mnoga, trzecia osoba, aspekt niedokonany, czas przeszły, tryb oznajmujący  
jak:spójnik 
gram: czasownik właściwy, liczba pojedyncza, osoba pierwsza, aspek niedokonany, czas teraźniejszy, tryb oznajmujący 
teraz: przysłówek 
usłyszą: czasownik właściwy, liczba mnoga, osoba trzecia, aspekt dokonany, czas przyszły, tryb oznajmujący
mój: zaimek, mianownik/biernik, m3, liczba pojedyncza, osoba pierwsza 
głos: rzeczownik, mianownik/biernik, m3, liczba pojedyncza
Umyśliłem: czasownik właściwy, liczba pojedyncza, osoba pierwsza, aspekt dokonany, czas przeszły, tryb oznajmujący
sobie: zaimek, celownik/ miejscownik, m1/m1/m3/n/f, liczba pojedyncza/mnoga
co: partykuła
powiem: czasownik właściwy, liczba pojedyncza, osoba pierwsza, aspekt dokonany, czas przyszły, tryb oznajmujący 
Im: spójnik 
prościej: przysłówek, stopień wyższy 
tym: spójnik 
lepiej: przysłówek, stopień wyższy 
Więc: spójnik 
mówię: czasownik właściwy, liczba pojedyncza, osoba pierwsza, aspekt niedokonany, czas teraźniejszy, tryb oznajmujący 
że: spójnik 
dobrze: przysłówek, stopień równy 
się: partykuła 
czuję: czasownik właściwy, liczba pojedyncza, osoba pierwsza, aspekt niedokonany, czas teraźniejszy, tryb oznajmujący 
w: przyimek
klimacie: rzeczownik, miejscownik, m3, liczba pojedyncza
napięcia: rzeczownik, dopełniacz, n, liczba pojedyncza
że: spójnik
w: przyimek 
skrytości: rzeczownik, dopełniacz, f, liczba pojedyncza
ducha: rzeczownik, dopełniacz, m2, liczba pojedyncza 
marzyłem: czasownik właściwy liczba pojedyncza, osoba pierwsza, aspekt niedokonany, czas przeszły, tryb oznajmujący 
o: przyimek 
konkursowych: przymiotnik, miejscownik, m3, liczba mnoga, stopień równy
laurach: rzeczownik, miejscownik, m3, liczba mnoga